---#---#---
A--$$----$$
---#---#---
#########$#
---#---#---
-.$--$$$$--
---#---#---
