---#$--#---
B--$---#-$-
---#--$----
#########-#
--$$---#---
-.-#---#-_-
---#---|-$-
