#########$  #####
   #        |   #
   #        # . #
#  #    #####   #
#  #### #  ####|#
#       #  B_    
#  ##   #   ##   
#####   ## ######
##### ###  ##   #
###             #
###   ###########
