#########$--#####
---#--------|---#
---#--------#-.-#
#--#----#####---#
#--####-#--####|#
#-------#--B_----
#--##---#---##---
#####---##-######
#####-###--##---#
###-------------#
###---###########
