-------#---
C$-#-------
-------#---
#####-###-#
---#---#---
-.-|-------
---#---#--_
