-----C-#---
-$-$-$-|-.$
-------#---
-$-$-$-####
-------####
-_-$-$-####
-------####
